R 1024 728
           NO       ./assets/redbrick.xpm
SO ./assets/sand.xpm
WE ./assets/stone.xpm
EA  ./assets/wall.xpm
 S ./assets/ammo.xpm
    C  255                                                       ,200,160
    F  122,122,  122

		1111111111111111111111111
		1000000000110000000000001
		1011000011110000020000001
		1001000020000000020000001
111111111111000001100200000000001
100000000011000001101111111111111
11110111111111011100000010001
11110111111111011101010010001
11000000110101011100000010001
10000000200000001100020010201
10000000000200001101210000001
11000001110101011111011110N0111
11110111 1110101 101111012001
11111111 1111111 111111111111
