R 1080 720
           NO       ./assets/redbrick.xpm
SO ./assets/sand.xpm
WE ./assets/stone.xpm
EA  ./assets/wood.xpm
 S ./assets/ammo.xpm
    C  255                                                       ,200,160
    F  122,122,  122

11111111111111111
11111110000000011
10000000000000001
10200002000001011
100N0000000000001
10002000200010001
10000000000000001
10202020002020101
10000000001110001
10002000201210001
10000000001010001
10200000201012001
10000000000010001
11111111111111111
